"filename", "language", "SCSS", "HTML", "TypeScript", "XML", "comment", "blank", "total"
"d:\mfhco\Documents\Uni\Moment\Moment\src\app\app-routing.module.ts", "TypeScript", 0, 0, 25, 0, 3, 3, 31
"d:\mfhco\Documents\Uni\Moment\Moment\src\app\app.component.html", "HTML", 0, 24, 0, 0, 0, 2, 26
"d:\mfhco\Documents\Uni\Moment\Moment\src\app\app.component.scss", "SCSS", 0, 0, 0, 0, 0, 1, 1
"d:\mfhco\Documents\Uni\Moment\Moment\src\app\app.component.spec.ts", "TypeScript", 0, 0, 36, 0, 1, 11, 48
"d:\mfhco\Documents\Uni\Moment\Moment\src\app\app.component.ts", "TypeScript", 0, 0, 42, 0, 28, 10, 80
"d:\mfhco\Documents\Uni\Moment\Moment\src\app\app.module.ts", "TypeScript", 0, 0, 34, 0, 8, 7, 49
"d:\mfhco\Documents\Uni\Moment\Moment\src\app\auth\auth-routing.module.ts", "TypeScript", 0, 0, 22, 0, 0, 4, 26
"d:\mfhco\Documents\Uni\Moment\Moment\src\app\auth\auth.guard.spec.ts", "TypeScript", 0, 0, 12, 0, 0, 4, 16
"d:\mfhco\Documents\Uni\Moment\Moment\src\app\auth\auth.guard.ts", "TypeScript", 0, 0, 26, 0, 16, 3, 45
"d:\mfhco\Documents\Uni\Moment\Moment\src\app\auth\auth.module.ts", "TypeScript", 0, 0, 16, 0, 0, 5, 21
"d:\mfhco\Documents\Uni\Moment\Moment\src\app\auth\auth.page.html", "HTML", 0, 7, 0, 0, 0, 3, 10
"d:\mfhco\Documents\Uni\Moment\Moment\src\app\auth\auth.page.scss", "SCSS", 0, 0, 0, 0, 0, 1, 1
"d:\mfhco\Documents\Uni\Moment\Moment\src\app\auth\auth.page.spec.ts", "TypeScript", 0, 0, 19, 0, 0, 6, 25
"d:\mfhco\Documents\Uni\Moment\Moment\src\app\auth\auth.page.ts", "TypeScript", 0, 0, 11, 0, 0, 5, 16
"d:\mfhco\Documents\Uni\Moment\Moment\src\app\auth\auth.service.ts", "TypeScript", 0, 0, 97, 0, 9, 17, 123
"d:\mfhco\Documents\Uni\Moment\Moment\src\app\auth\login\login-routing.module.ts", "TypeScript", 0, 0, 14, 0, 0, 4, 18
"d:\mfhco\Documents\Uni\Moment\Moment\src\app\auth\login\login.module.ts", "TypeScript", 0, 0, 17, 0, 0, 5, 22
"d:\mfhco\Documents\Uni\Moment\Moment\src\app\auth\login\login.page.html", "HTML", 0, 47, 0, 0, 0, 2, 49
"d:\mfhco\Documents\Uni\Moment\Moment\src\app\auth\login\login.page.scss", "SCSS", 0, 0, 0, 0, 0, 1, 1
"d:\mfhco\Documents\Uni\Moment\Moment\src\app\auth\login\login.page.spec.ts", "TypeScript", 0, 0, 19, 0, 0, 6, 25
"d:\mfhco\Documents\Uni\Moment\Moment\src\app\auth\login\login.page.ts", "TypeScript", 0, 0, 61, 0, 1, 10, 72
"d:\mfhco\Documents\Uni\Moment\Moment\src\app\auth\register\personal-info\personal-info.component.html", "HTML", 0, 45, 0, 0, 0, 1, 46
"d:\mfhco\Documents\Uni\Moment\Moment\src\app\auth\register\personal-info\personal-info.component.scss", "SCSS", 0, 0, 0, 0, 0, 1, 1
"d:\mfhco\Documents\Uni\Moment\Moment\src\app\auth\register\personal-info\personal-info.component.spec.ts", "TypeScript", 0, 0, 19, 0, 0, 6, 25
"d:\mfhco\Documents\Uni\Moment\Moment\src\app\auth\register\personal-info\personal-info.component.ts", "TypeScript", 0, 0, 102, 0, 38, 25, 165
"d:\mfhco\Documents\Uni\Moment\Moment\src\app\auth\register\register-routing.module.ts", "TypeScript", 0, 0, 14, 0, 0, 4, 18
"d:\mfhco\Documents\Uni\Moment\Moment\src\app\auth\register\register.module.ts", "TypeScript", 0, 0, 20, 0, 0, 5, 25
"d:\mfhco\Documents\Uni\Moment\Moment\src\app\auth\register\register.page.html", "HTML", 0, 64, 0, 0, 0, 1, 65
"d:\mfhco\Documents\Uni\Moment\Moment\src\app\auth\register\register.page.scss", "SCSS", 0, 0, 0, 0, 0, 1, 1
"d:\mfhco\Documents\Uni\Moment\Moment\src\app\auth\register\register.page.spec.ts", "TypeScript", 0, 0, 19, 0, 0, 6, 25
"d:\mfhco\Documents\Uni\Moment\Moment\src\app\auth\register\register.page.ts", "TypeScript", 0, 0, 72, 0, 32, 9, 113
"d:\mfhco\Documents\Uni\Moment\Moment\src\app\auth\user.spec.ts", "TypeScript", 0, 0, 6, 0, 0, 2, 8
"d:\mfhco\Documents\Uni\Moment\Moment\src\app\auth\user.ts", "TypeScript", 0, 0, 10, 0, 0, 2, 12
"d:\mfhco\Documents\Uni\Moment\Moment\src\app\content\content.component.html", "HTML", 0, 7, 0, 0, 0, 0, 7
"d:\mfhco\Documents\Uni\Moment\Moment\src\app\content\content.component.scss", "SCSS", 19, 0, 0, 0, 0, 3, 22
"d:\mfhco\Documents\Uni\Moment\Moment\src\app\content\content.component.spec.ts", "TypeScript", 0, 0, 19, 0, 0, 6, 25
"d:\mfhco\Documents\Uni\Moment\Moment\src\app\content\content.component.ts", "TypeScript", 0, 0, 27, 0, 0, 7, 34
"d:\mfhco\Documents\Uni\Moment\Moment\src\app\event.ts", "TypeScript", 0, 0, 16, 0, 3, 2, 21
"d:\mfhco\Documents\Uni\Moment\Moment\src\app\events.service.ts", "TypeScript", 0, 0, 111, 0, 67, 18, 196
"d:\mfhco\Documents\Uni\Moment\Moment\src\app\image-chooser\image-chooser.component.html", "HTML", 0, 23, 0, 0, 0, 2, 25
"d:\mfhco\Documents\Uni\Moment\Moment\src\app\image-chooser\image-chooser.component.scss", "SCSS", 10, 0, 0, 0, 0, 3, 13
"d:\mfhco\Documents\Uni\Moment\Moment\src\app\image-chooser\image-chooser.component.spec.ts", "TypeScript", 0, 0, 19, 0, 0, 6, 25
"d:\mfhco\Documents\Uni\Moment\Moment\src\app\image-chooser\image-chooser.component.ts", "TypeScript", 0, 0, 27, 0, 108, 7, 142
"d:\mfhco\Documents\Uni\Moment\Moment\src\app\post-comment.service.ts", "TypeScript", 0, 0, 25, 0, 0, 4, 29
"d:\mfhco\Documents\Uni\Moment\Moment\src\app\post-comment.ts", "TypeScript", 0, 0, 6, 0, 0, 1, 7
"d:\mfhco\Documents\Uni\Moment\Moment\src\app\post.ts", "TypeScript", 0, 0, 11, 0, 0, 2, 13
"d:\mfhco\Documents\Uni\Moment\Moment\src\app\posts.service.ts", "TypeScript", 0, 0, 115, 0, 58, 18, 191
"d:\mfhco\Documents\Uni\Moment\Moment\src\app\search\search.component.html", "HTML", 0, 74, 0, 0, 2, 3, 79
"d:\mfhco\Documents\Uni\Moment\Moment\src\app\search\search.component.scss", "SCSS", 13, 0, 0, 0, 0, 3, 16
"d:\mfhco\Documents\Uni\Moment\Moment\src\app\search\search.component.spec.ts", "TypeScript", 0, 0, 19, 0, 0, 6, 25
"d:\mfhco\Documents\Uni\Moment\Moment\src\app\search\search.component.ts", "TypeScript", 0, 0, 120, 0, 0, 16, 136
"d:\mfhco\Documents\Uni\Moment\Moment\src\app\shared\content\content.component.html", "HTML", 0, 3, 0, 0, 0, 1, 4
"d:\mfhco\Documents\Uni\Moment\Moment\src\app\shared\content\content.component.scss", "SCSS", 0, 0, 0, 0, 0, 1, 1
"d:\mfhco\Documents\Uni\Moment\Moment\src\app\shared\content\content.component.spec.ts", "TypeScript", 0, 0, 19, 0, 0, 6, 25
"d:\mfhco\Documents\Uni\Moment\Moment\src\app\shared\content\content.component.ts", "TypeScript", 0, 0, 10, 0, 0, 5, 15
"d:\mfhco\Documents\Uni\Moment\Moment\src\app\shared\content\content.module.ts", "TypeScript", 0, 0, 17, 0, 1, 4, 22
"d:\mfhco\Documents\Uni\Moment\Moment\src\app\shared\feedback.spec.ts", "TypeScript", 0, 0, 6, 0, 0, 2, 8
"d:\mfhco\Documents\Uni\Moment\Moment\src\app\shared\feedback.ts", "TypeScript", 0, 0, 5, 0, 0, 1, 6
"d:\mfhco\Documents\Uni\Moment\Moment\src\app\shared\feedback\feedback.component.html", "HTML", 0, 35, 0, 0, 1, 1, 37
"d:\mfhco\Documents\Uni\Moment\Moment\src\app\shared\feedback\feedback.component.scss", "SCSS", 0, 0, 0, 0, 0, 1, 1
"d:\mfhco\Documents\Uni\Moment\Moment\src\app\shared\feedback\feedback.component.spec.ts", "TypeScript", 0, 0, 19, 0, 0, 6, 25
"d:\mfhco\Documents\Uni\Moment\Moment\src\app\shared\feedback\feedback.component.ts", "TypeScript", 0, 0, 39, 0, 0, 7, 46
"d:\mfhco\Documents\Uni\Moment\Moment\src\app\tabs\events\event-detail\event-detail.component.html", "HTML", 0, 62, 0, 0, 0, 2, 64
"d:\mfhco\Documents\Uni\Moment\Moment\src\app\tabs\events\event-detail\event-detail.component.scss", "SCSS", 0, 0, 0, 0, 0, 1, 1
"d:\mfhco\Documents\Uni\Moment\Moment\src\app\tabs\events\event-detail\event-detail.component.spec.ts", "TypeScript", 0, 0, 19, 0, 0, 6, 25
"d:\mfhco\Documents\Uni\Moment\Moment\src\app\tabs\events\event-detail\event-detail.component.ts", "TypeScript", 0, 0, 93, 0, 0, 12, 105
"d:\mfhco\Documents\Uni\Moment\Moment\src\app\tabs\events\event-discover\event-discover.component.html", "HTML", 0, 27, 0, 0, 0, 3, 30
"d:\mfhco\Documents\Uni\Moment\Moment\src\app\tabs\events\event-discover\event-discover.component.scss", "SCSS", 0, 0, 0, 0, 0, 1, 1
"d:\mfhco\Documents\Uni\Moment\Moment\src\app\tabs\events\event-discover\event-discover.component.spec.ts", "TypeScript", 0, 0, 19, 0, 0, 6, 25
"d:\mfhco\Documents\Uni\Moment\Moment\src\app\tabs\events\event-discover\event-discover.component.ts", "TypeScript", 0, 0, 103, 0, 0, 15, 118
"d:\mfhco\Documents\Uni\Moment\Moment\src\app\tabs\events\events-routing.module.ts", "TypeScript", 0, 0, 14, 0, 0, 4, 18
"d:\mfhco\Documents\Uni\Moment\Moment\src\app\tabs\events\events.module.ts", "TypeScript", 0, 0, 18, 0, 0, 5, 23
"d:\mfhco\Documents\Uni\Moment\Moment\src\app\tabs\events\events.page.html", "HTML", 0, 42, 0, 0, 0, 1, 43
"d:\mfhco\Documents\Uni\Moment\Moment\src\app\tabs\events\events.page.scss", "SCSS", 5, 0, 0, 0, 0, 1, 6
"d:\mfhco\Documents\Uni\Moment\Moment\src\app\tabs\events\events.page.spec.ts", "TypeScript", 0, 0, 19, 0, 0, 6, 25
"d:\mfhco\Documents\Uni\Moment\Moment\src\app\tabs\events\events.page.ts", "TypeScript", 0, 0, 95, 0, 0, 15, 110
"d:\mfhco\Documents\Uni\Moment\Moment\src\app\tabs\events\new-event\new-event.component.html", "HTML", 0, 86, 0, 0, 0, 1, 87
"d:\mfhco\Documents\Uni\Moment\Moment\src\app\tabs\events\new-event\new-event.component.scss", "SCSS", 0, 0, 0, 0, 0, 1, 1
"d:\mfhco\Documents\Uni\Moment\Moment\src\app\tabs\events\new-event\new-event.component.spec.ts", "TypeScript", 0, 0, 19, 0, 0, 6, 25
"d:\mfhco\Documents\Uni\Moment\Moment\src\app\tabs\events\new-event\new-event.component.ts", "TypeScript", 0, 0, 85, 0, 1, 21, 107
"d:\mfhco\Documents\Uni\Moment\Moment\src\app\tabs\feed\feed-routing.module.ts", "TypeScript", 0, 0, 14, 0, 0, 4, 18
"d:\mfhco\Documents\Uni\Moment\Moment\src\app\tabs\feed\feed.module.ts", "TypeScript", 0, 0, 23, 0, 0, 5, 28
"d:\mfhco\Documents\Uni\Moment\Moment\src\app\tabs\feed\feed.page.html", "HTML", 0, 83, 0, 0, 47, 2, 132
"d:\mfhco\Documents\Uni\Moment\Moment\src\app\tabs\feed\feed.page.scss", "SCSS", 22, 0, 0, 0, 0, 3, 25
"d:\mfhco\Documents\Uni\Moment\Moment\src\app\tabs\feed\feed.page.spec.ts", "TypeScript", 0, 0, 19, 0, 0, 6, 25
"d:\mfhco\Documents\Uni\Moment\Moment\src\app\tabs\feed\feed.page.ts", "TypeScript", 0, 0, 143, 0, 73, 26, 242
"d:\mfhco\Documents\Uni\Moment\Moment\src\app\tabs\feed\new-post\new-post.component.html", "HTML", 0, 44, 0, 0, 0, 1, 45
"d:\mfhco\Documents\Uni\Moment\Moment\src\app\tabs\feed\new-post\new-post.component.scss", "SCSS", 0, 0, 0, 0, 0, 1, 1
"d:\mfhco\Documents\Uni\Moment\Moment\src\app\tabs\feed\new-post\new-post.component.spec.ts", "TypeScript", 0, 0, 19, 0, 0, 6, 25
"d:\mfhco\Documents\Uni\Moment\Moment\src\app\tabs\feed\new-post\new-post.component.ts", "TypeScript", 0, 0, 129, 0, 1, 28, 158
"d:\mfhco\Documents\Uni\Moment\Moment\src\app\tabs\feed\post-detail\post-detail.component.html", "HTML", 0, 101, 0, 0, 0, 4, 105
"d:\mfhco\Documents\Uni\Moment\Moment\src\app\tabs\feed\post-detail\post-detail.component.scss", "SCSS", 16, 0, 0, 0, 0, 2, 18
"d:\mfhco\Documents\Uni\Moment\Moment\src\app\tabs\feed\post-detail\post-detail.component.spec.ts", "TypeScript", 0, 0, 19, 0, 0, 6, 25
"d:\mfhco\Documents\Uni\Moment\Moment\src\app\tabs\feed\post-detail\post-detail.component.ts", "TypeScript", 0, 0, 114, 0, 8, 19, 141
"d:\mfhco\Documents\Uni\Moment\Moment\src\app\tabs\feed\post-discover\post-discover.component.html", "HTML", 0, 72, 0, 0, 0, 3, 75
"d:\mfhco\Documents\Uni\Moment\Moment\src\app\tabs\feed\post-discover\post-discover.component.scss", "SCSS", 16, 0, 0, 0, 0, 2, 18
"d:\mfhco\Documents\Uni\Moment\Moment\src\app\tabs\feed\post-discover\post-discover.component.spec.ts", "TypeScript", 0, 0, 19, 0, 0, 6, 25
"d:\mfhco\Documents\Uni\Moment\Moment\src\app\tabs\feed\post-discover\post-discover.component.ts", "TypeScript", 0, 0, 132, 0, 50, 26, 208
"d:\mfhco\Documents\Uni\Moment\Moment\src\app\tabs\people\people-routing.module.ts", "TypeScript", 0, 0, 14, 0, 0, 4, 18
"d:\mfhco\Documents\Uni\Moment\Moment\src\app\tabs\people\people.module.ts", "TypeScript", 0, 0, 18, 0, 0, 5, 23
"d:\mfhco\Documents\Uni\Moment\Moment\src\app\tabs\people\people.page.html", "HTML", 0, 36, 0, 0, 0, 1, 37
"d:\mfhco\Documents\Uni\Moment\Moment\src\app\tabs\people\people.page.scss", "SCSS", 0, 0, 0, 0, 0, 1, 1
"d:\mfhco\Documents\Uni\Moment\Moment\src\app\tabs\people\people.page.spec.ts", "TypeScript", 0, 0, 19, 0, 0, 6, 25
"d:\mfhco\Documents\Uni\Moment\Moment\src\app\tabs\people\people.page.ts", "TypeScript", 0, 0, 35, 0, 37, 7, 79
"d:\mfhco\Documents\Uni\Moment\Moment\src\app\tabs\profile\profile-routing.module.ts", "TypeScript", 0, 0, 14, 0, 0, 4, 18
"d:\mfhco\Documents\Uni\Moment\Moment\src\app\tabs\profile\profile.module.ts", "TypeScript", 0, 0, 21, 0, 0, 5, 26
"d:\mfhco\Documents\Uni\Moment\Moment\src\app\tabs\profile\profile.page.html", "HTML", 0, 62, 0, 0, 0, 1, 63
"d:\mfhco\Documents\Uni\Moment\Moment\src\app\tabs\profile\profile.page.scss", "SCSS", 26, 0, 0, 0, 0, 6, 32
"d:\mfhco\Documents\Uni\Moment\Moment\src\app\tabs\profile\profile.page.spec.ts", "TypeScript", 0, 0, 19, 0, 0, 6, 25
"d:\mfhco\Documents\Uni\Moment\Moment\src\app\tabs\profile\profile.page.ts", "TypeScript", 0, 0, 94, 0, 58, 17, 169
"d:\mfhco\Documents\Uni\Moment\Moment\src\app\tabs\tabs-routing.module.ts", "TypeScript", 0, 0, 56, 0, 3, 5, 64
"d:\mfhco\Documents\Uni\Moment\Moment\src\app\tabs\tabs.module.ts", "TypeScript", 0, 0, 20, 0, 0, 5, 25
"d:\mfhco\Documents\Uni\Moment\Moment\src\app\tabs\tabs.page.html", "HTML", 0, 20, 0, 0, 0, 6, 26
"d:\mfhco\Documents\Uni\Moment\Moment\src\app\tabs\tabs.page.scss", "SCSS", 0, 0, 0, 0, 0, 1, 1
"d:\mfhco\Documents\Uni\Moment\Moment\src\app\tabs\tabs.page.spec.ts", "TypeScript", 0, 0, 19, 0, 0, 6, 25
"d:\mfhco\Documents\Uni\Moment\Moment\src\app\tabs\tabs.page.ts", "TypeScript", 0, 0, 11, 0, 0, 5, 16
"d:\mfhco\Documents\Uni\Moment\Moment\src\app\user.ts", "TypeScript", 0, 0, 11, 0, 0, 2, 13
"d:\mfhco\Documents\Uni\Moment\Moment\src\app\users.service.ts", "TypeScript", 0, 0, 104, 0, 65, 17, 186
"d:\mfhco\Documents\Uni\Moment\Moment\src\assets\mmnt-io – Firebase console.html", "HTML", 0, 2416, 0, 0, 12, 179, 2607
"d:\mfhco\Documents\Uni\Moment\Moment\src\assets\mmnt-io – Firebase console_files\alternategtm.html", "HTML", 0, 11, 0, 0, 1, 0, 12
"d:\mfhco\Documents\Uni\Moment\Moment\src\assets\mmnt-io – Firebase console_files\firebase_logotype_grey_18dp.svg", "XML", 0, 0, 0, 11, 1, 0, 12
"d:\mfhco\Documents\Uni\Moment\Moment\src\assets\mmnt-io – Firebase console_files\firebase_logotype_white_18dp.svg", "XML", 0, 0, 0, 3, 0, 1, 4
"d:\mfhco\Documents\Uni\Moment\Moment\src\assets\mmnt-io – Firebase console_files\postmessageRelay.html", "HTML", 0, 2, 0, 0, 1, 0, 3
"d:\mfhco\Documents\Uni\Moment\Moment\src\assets\mmnt-io – Firebase console_files\proxy(1).html", "HTML", 0, 13, 0, 0, 1, 2, 16
"d:\mfhco\Documents\Uni\Moment\Moment\src\assets\mmnt-io – Firebase console_files\proxy(2).html", "HTML", 0, 13, 0, 0, 1, 2, 16
"d:\mfhco\Documents\Uni\Moment\Moment\src\assets\mmnt-io – Firebase console_files\proxy(3).html", "HTML", 0, 13, 0, 0, 1, 2, 16
"d:\mfhco\Documents\Uni\Moment\Moment\src\assets\mmnt-io – Firebase console_files\proxy(4).html", "HTML", 0, 13, 0, 0, 1, 2, 16
"d:\mfhco\Documents\Uni\Moment\Moment\src\assets\mmnt-io – Firebase console_files\proxy.html", "HTML", 0, 13, 0, 0, 1, 2, 16
"d:\mfhco\Documents\Uni\Moment\Moment\src\assets\shapes.svg", "XML", 0, 0, 0, 1, 0, 1, 2
"d:\mfhco\Documents\Uni\Moment\Moment\src\environments\environment.prod.ts", "TypeScript", 0, 0, 4, 0, 0, 2, 6
"d:\mfhco\Documents\Uni\Moment\Moment\src\environments\environment.ts", "TypeScript", 0, 0, 4, 0, 11, 3, 18
"d:\mfhco\Documents\Uni\Moment\Moment\src\global.scss", "SCSS", 33, 0, 0, 0, 13, 8, 54
"d:\mfhco\Documents\Uni\Moment\Moment\src\index.html", "HTML", 0, 21, 0, 0, 1, 8, 30
"d:\mfhco\Documents\Uni\Moment\Moment\src\main.ts", "TypeScript", 0, 0, 12, 0, 0, 7, 19
"d:\mfhco\Documents\Uni\Moment\Moment\src\polyfills.ts", "TypeScript", 0, 0, 2, 0, 55, 10, 67
"d:\mfhco\Documents\Uni\Moment\Moment\src\test.ts", "TypeScript", 0, 0, 13, 0, 4, 4, 21
"d:\mfhco\Documents\Uni\Moment\Moment\src\theme\variables.scss", "SCSS", 60, 0, 0, 0, 3, 12, 75
"d:\mfhco\Documents\Uni\Moment\Moment\src\zone-flags.ts", "TypeScript", 0, 0, 1, 0, 4, 1, 6
"Total", "-", 220, 3479, 2949, 15, 830, 928, 8421